11111111111111111111111111111111111111111111111111111111111111111111111111111111111111111111111111111111111111111111111111111111
11111111111111111111100000000000000000000000000000000000000000000000000000000000000000000000000000000000000000000000000000000001
11111111111111111111100000000000000000000000000000000000000000000000000000000000000000000000000000000000000000000000000000000001
11111111111111111111100111111111111111111111111111111111111111111111111111111111111111111111111111111111111111111111111111111001
11111111111111111111100100000000000000000000000000000000000000000000100000000000000000000000000000000000000000000000000000001001
11111111111111111111100100000000000000000000000000000000000000000000100111111111111111111111111111111111111111111111111111101001
11111111111111111111100100000000000000000000000000000000000000000000100111111111111111111111111111111111111111111111111111101001
11111111111111111111100100000000000000000000000000000000000000000000100111111111111111111111111111111111111111111111111111101001
11111111111111111111100100000000000000000000000000000000000001111111111111111111111111111111111111111111111111111111111111101001
11111111111111111111100100000001111111111111111111100000000000000000100111111111111111111111111111111111111111111111111111101001
11111111111111111111100100000000000000000000000000000000000000000000100111111111111111111111111111111111111111111111111111101001
11111111111111111111100100000000000000000000000000000000000000000000100111111111111111111111111111111111111111111111111111101001
11111111111111111111100100000000000000000000000000000000000000000000100111111111111111111111111111111111111111111111111111101001
11111111111111111111100100000000000000000000000000000000000110000000100111111111111111111111111111111111111111111111111111101001
11111111111111111111100111111111111111111111111111111111111100000000100111111111111111111111111111111111111111111111111111101001
11111111111111111111100000000000000000000000000000000000000100000000100111111111111111111111111111111111111111111111111111101001
11111111111111111111100000000000000000000000000000000000000100000000100111111111111111111111111111111111111111111111111111101001
11111111111111111111100000000000000000000000000000000000000100000000100111111111111111111111111111111111111111111111111111101001
11111111111111111111100000000000000000000000000000000000000100000000100111111111111111111111111111111111111111111111111111101001
11111111111111111111100000000000000000000000000000000000000100000000100111111111111111111111111111111111111111111111111111101001
11111111111111111111111111111111111111111111111111111111000100000000100111111111111111111111111111111111111111111111111111101001
11111111111111111111100000000000000000000000000000000001000100000000100111111111111111111111111111111111111111111111111111101001
11111111111111111111111111111111111111111111111111111111000100000000100111111111111111111111111111111111111111111111111111101001
11111111111111111111111111111111111111111111111111111111000100000000100111111111111111111111111111111111111111111111111111101001
11111111111111111111111111111111111111111111111111111111000100000000100111111111111111111111111111111111111111111111111111101001
11111111111111111111111111111111111111111111111111111111000100000000100111111111111111111111111111111111111111111111111111101001
11111111111111111111111111111111111111111111111111111111000100000000100111111111111111111111111111111111111111111111111111101001
11111111111111111111111111111111111111111111111111111111000100000000100111111111111111111111111111111111111111111111111111101001
11111111111111111111111111111111111111111111111111111111020100000000100111111111111111111111111111111111111111111111111111101001
11111111111111111111111111111111111111111111111111111111000100000000100111111111111111111111111111111111111111111111111111101001
11111111111111111111111111111111111111111111111111111111000100000000100111111111111111111111111111111111111111111111111111101001
11111111111111111111111111111111111111111111111111111111000100000000100111111111111111111111111111111111111111111111111111101001
11111111111111111111111111111111111111111111111111111111111110000000100000011111111111110000000100000000000001000000000100001001
11111111111111111111111111111111111111111111111111111110000000000000100000011111111111110000000100000000000001000000000100001001
11111111111111111111111111111111111111111111111111111110000000000000000011111111111111111111111111111111111111111111111111000001
11111111111111111111111111111111111111111111111111111110000000000000000011111111111111111111111111111111111111111111111111000001
11111111111111111111111111111111111111111111111111111110000000000000000011111111111111111111111111111111111111111111111111000001
11111111111111111111111111111111111111111111111111111110001111111111111111111111111111111111111111111111111111111111111111000001
11111111111111111111111111111111111111111111111111111110001111111111111111111111111111111111111111111111111111111111111111000001
11111111111111111111111111111111111111111111111111111110001111111111111111111111111111111111111111111111111111111111111111000001
11111111111111111111111111111111111111111111111111111110001111111111111111111111111111111111111111111111111111111111111111000001
11111111111111111111111111111111111111111111111111111110001111111111111111111111111111111111111111111111111111111111111111000001
11111111111111111111111111111111111111111111111111111110001111111111111111111111111111111111111111111111111111111111111111000001
11111111111111111111111111111111111111111111111111111110001111111111111111111111111111111111111111111111111111111111111111000001
11111111111111111111111111111111111111111111111111111110001111111111111111111111111111111111111111111111111111111111111111000001
11111111111111111111111111111111111111111111111111111110001111111111111111111111111111111111111111111111111111111111111111000001
11111111111111111111111111111111111111111111111111111110001111111111111111111111111111111111111111111111111111111111111111000001
11111111111111111111111111111111111111111111111111111110001111111111111111111111111111111111111111111111111111111111111111000001
11111111111111111111111111111111111111111111111111111111111111111111111111111111111111111111111111111111111111111111111111000001
11111111111111111111111111111111111111111111111100000000000000000000000011111111111111111111111111111111111111111111111111000001
11111111111111111111111111111111111111111111111100000000000000000000000011111111111111111111111111111111111111111111111111000001
10000011111111111000000000000000000000000100000100000000000000000000000011111111111111111111111111111111111111111111111111000001
10000000000000000000000000000000000000000100000100000000000000000000000011111111111111111111111111111111111111111111111111000001
10000000000000000000000000000000000000000100000100000000000000000000000011111111111111111111111111111111111111111111111111000001
10000000011111111111111111111000000000000100000100000000000000000000000011111111111111111111111111111111111111111111111111000001
10000000000000000000000000000000000000000100000100000000000000000000000011111111111111111111111111111111111111111111111111000001
10000000000000000000000000000000000000000100000100000000000000000000000011111111111111111111111111111111111111111111111111000001
10000000000000000000000000000000000000000100000100000000000000000000000011111111111111111111111111111111111111111111111111000001
10000000000000000000000000000000000000000100000100000000000000000000000011111111111111111111111111111111111111111111111111000001
10000000000000000000000000000000000000000100000100000000000000000000000011111111111111111111111111111111111111111111111111000001
10000000000000000000000000000000000000000000000000000000000000000000000011111111111111111111111111111111111111111111111111000001
10000000000000001111111111111111111100000000000000000000000000000000000000000000000000000000000000000000000000000000000000000001
10011111111111111111111111111111111111111111111111111111111111111111111111111111111111111111111111111111111111111111111111111111
10010000000000000000000000000000000000000000000000000000000000000000000000000000000000000000000000000000000000000000000000000001
10010011111111111111111111111111111111111111111111111111111111111111111000000000000000000000000000000000000000000000000000000001
10010011111111111111111111111111111111111111111111111111111111111111111000000000000000000000000000000000000000000000000000000001
10010011111111111111111111111111111111111111111111111111111111111111111000000000000000000000000000000000000000000000000000000001
10010011111111111111111111111111111111111111111111111111111111111111111000000000000000000000000000000111111111111111000000000001
10010011111111111111111111111111111111111111111111111111111111111111111000000000000000000000000000000111111111111111001000000001
10010011111111111111111111111111111111111111111111111111111111111111111111111111000000000000000000000111111111111111001000000001
10010011111111111111111111111111111111111111111111111111111111111111111000000000000000000000000000000111111111111111001000000001
10010011111111111111111111111111111111111111111111111111111111111111111000000000000000000000000000000111111111111111001000000001
10010011111111111111111111111111111111111111111111111111111111111111111000000000000000000000000000000111111111111111001000000001
10010011111111111111111111111111111111111111111111111111111111111111111000000000000000000000000000000111111111111111001000000001
10010011111111111111111111111111111111111111111111111111111111111111111000000000000000001111111111111111111111111111001000000001
10010011111111111111111111111111111111111111111111111111111111111111111000000000000000001111111111111111111111111111001000000001
10010011111111111111111111111111111111111111111111111111111111111111111000000000000000001111111111111111111111111111001000000001
10010011111111111111111111111111111111111111111111111111111111111111111110000000000000001111111111111111111111111111001000000001
10010011111111111111111111111111111111111111111111111111111111111111111000000000000000001111111111111111111111111111001000000001
10010011111111111111111111111111111111111111111111111111111111111111111000000000000000001111111111111111111111111111001000000001
10010011111111111111111111111111111111111111111111111111111111111111111000000000000000001111111111111111111111111111001000000001
10010011111111111111111111111111111111111111111111111111111111111111111000000000000000001111111111111111111111111111001000000001
10010011111111111111111111111111111111111111111111111111111111111111111000000000000000001111111111111111111111111111001000000001
10010011111111111111111111111111111111111111111111111111111111111111111000000000000000001111111111111111111111111111001000000001
10010011111111111111111111111111111111111111111111111111111111111111111000000000000000001111111111111111111111111111001000000001
10010011001111111111100100000011111111111111111111111111111110000000000000000000000000001111111111111111111111111111001000000001
10010011001111111111100100000011111111111111111111111111111110000000000000000111111111111111111111111111111111111111001000000001
10010011001111111111100100000011111111111111111111111111111110000000000000000111111111111111111111111111111111111111001000000001
10010011001111111111100100000000000000010000001000111111111110000000000000000111111111111111111111111111111111111111001000000001
10010011001111111111100100000000000000010000001000111111111110000000000000000111111111111111111111111111111111111111111111100001
10010011001111111111100100000000000000010000001000111111111110000000000000000111111111111111111111111111111111111111001000000001
10010001001111111111100100000000000000010000001000111111111110000000000000000111111111111111111111111111111111111111001000000001
10010001001111111111100100000000000000010000001000000000000000000000000000000111111111111111111111111111111111111111001000000001
10010001001111111111100100111111111111111111111000000000000000000000000000000111111111111111111111111111111111111111001000000001
10010001001111111111100100000000000000010000001000000000000000000000000000000111111111111111111111111111111111111111001000000001
10010001001111111111100100001111111111110000001000000000000000000000000000000111111111111111111111111111111111111111001000000001
10010001001111111111100000001111111111110000001000000000000000000000000000000111111111111111111111111111111111111111001000000001
10010001001111111111100000001111111111110000001000000000000000000000000000000111111111111111111111111111111111111111001000000001
10010000001111111111100000001111111111110000001000000000000000000000000000000111111111111111111111111111111111111111001000000001
10010000001111111111100000001111111111111111111000000000000000000000000000000111111111111111111111111111111111111111000000000001
10010000001111111111100000001111111111111111111000000000000000000000000000000111111111111111111111111111000000000000000000000001
10010000000010000000000000001111111111111111111000000000000000000000000000000111111111111111111111111111000000000000000000000001
10010000000010000000000000001111111111111111111000000000000000000000000000000111111111111111111111111111000000000000000000000001
10010000011111111111111111111111111111111111111000000000000000000000000000000111111111111111111111111111000000000000000000000001
10010000000010000000000000001111111111111111111000000000000000000000000000000111111111111111111111111111000000000000000000000001
10010000000010000000000000001111111111111111111000000000000000000000000000000111111111111111111111111111000000000000000000000001
10010000000010000000000000001111111111111111111000000011111111111111111111111111111111111111111111111111111111111111111111100001
10010000000010000000000000001111111111111111111000000000000000000000000000000111111111111111111110001000000000000000000000000001
10010000000010000000000000001111111111111111111000000000000000000000000000000111111111111111111111111111111111111000000000000001
10010000000010000000000000001111111111111111111000000000000000000000000000000111111111111111111111111111111111111000000000000001
10010000000010000000000000001111111111111111111000000000000000000000000000000111111111111111111111111111111111111000000000000001
10010000000111111111111111111111111111111111111000000000000000000000000000000111111111111111111111111111111111111000000000000001
10010000000111111111111111111111111111111111111000000000000010000000000000000111111111111111111111111111111111111000000000000001
10010000000111111111111111111111111111111111111000000000000010000000000000000111111111111111111111111111111111111000000000000001
10000000000111111111111111111111111111111111111000000000000010000000000000000111111111111111111111111111111111111000000000000001
10000000000111111111111111111111111111111111111000000000000010000000000000000111111111111111111111111111111111111000000000000001
10000000000111111111111111111111111111111111111000000000000010000000000000000111111111111111111111111111111111111000000000000001
10000000000111111111111111111111111111111111111000000000000010000000000000000111111111111111111111111111111111111000000000000001
10000000000111111111111111111111111111111111111000000000000010000000000000000111111111111111111111111111111111111000000000000001
10000000000111111111111111111111111111111111111000000000000010000000000000000000000000001000011111111111111111111000000000000001
10000000000000000000000000001111111111111111111000000000000010000000000000000000000000001000011111111111111111111000000000000001
10000000000000000000000000001111111111111111111000000000000010000000000000000000000000111111111111111111111111111000000000000001
10000000000000000000000000001111111111111111111000000000000010000000000000000000000000001000011111111111111111111000000000000001
10000000000000000000000000000000000011111111111000000000000010000000000000000000000000000000011111111111111111111000000000000001
10001111111111111111111111111111111111111111111111111111111111111111111110000000000000000000011111111111111111111000000000000001
10000000000000000000000000000000000011111111111000000000000010100000000000000000000000000000000000000000000000000000000000000001
10000000000000000000000000000000000011111111111000000000000010300000000000000000000000000000000000000000000000000000000000000001
11111111111111111111111111111111111111111111111111111111111111111111111111111111111111111111111111111111111111111111111111111111