0000000000000000000000000000000000000000000000000000000000000000
0211111111111111111111111111110111111111100000000000000000000000
0100000000000000000000000000010100000000101111111101111100000000
0101111111111111111111111111010101111111101000000101010000000000
0101000000000000000000000000010101000000101001010101011111111110
0101011111111111111111111100010101011100101001010101010000000000
0101010000000000000000000111110101010100101001010101010000000000
0101111111111111111100000100000101010100101001010101010000000000
0101010000000000000000000100100101010100101001010101011111111110
0101010000000000000000000100100101010100101001010101010000000000
0101011111111111111111111111100101010100101001010101000000000000
0101000000000000000000000100100101010100101001010101111111111100
0101111111111111111111100100100101010100101001010100000000000100
0100010000000000000000000100100101010100101111011111111111110100
0100010111111111111111000100100101010100100001000000000000100100
0100010100000000000001000100100101010100100101000000000000100100
0100010100000000000101000100100101010100100111111111111100100100
0100010111111111110101000100100101010100100100000000000000100100
0100010000000000010101111100100101010100100101111111111110111100
0100011111111111011101000100100101010100100101000000000010100000
0100010000000000000001000100100101010100100101011110111010101000
0100010111111111111111000100100101010100100101010000100010101110
0100010000000000100001000100100101010100100101010000101010101010
0101111111111000100001000100100101010100100101011111101010101010
0100010000000000100001000100100101010100100101000000101010101010
0100010000000000100001000100100101010100100101111110101010101010
0101111111111000100001000100100101010100111100000010101010101010
0100010000000000100001000100100101010100000000000010101010101010
0100011111111111111111111111100101010100000000000010101010101010
0100010000000000100001000100000101010100111111111110101010101010
0100010000001111111111000100000101010100100000000000101010101010
0101111111111000101001000100000101010100100000000000101010101010
0100000000000000101001000100000101010100100111111110101011111110
0100000000000000101001000100000101010100100101000000101010100010
0101111111111111101001000100000101010100100101000000101010100010
0101000000000000001001000100111101010100100101011111111010100010
0101011111111111111111111100100101010100100101000000001010000010
0101000000000000001001000000100101010100100101000000001010111110
0101011111111110001001000000100101010100100101111111111010100000
0101000000000010001001000100100101110100100100000000000010100010
0101000000000010001001000100100100000100100111111111111110100010
0101111111111010001001000100100100000100100100000000000000111010
0101000000000010001000000100100101111100100100000000000000100010
0101000000000010001000000100100101000000100101031111111111101010
0111111111111111111111111111100101011111100101000000000000101010
0100000000000000000010000100100101010000000111111111111110101010
0101111111111111111010000100100101010000000000000000000000001010
0101000000000000001010000100100101011111111111111111111111101010
0101111111111111101010000100100101000000000000000000000000101010
0100000000000000001011110100100101011111111111111111111111101010
0100000000000010001010000100100101000000000000000000100000101010
0100000000000010001000000100100101011111111111111110100000101010
0100111111111111111111111100100101010000000000000010111110111010
0100000000000010000000000100100101011111111111111010000000100010
0100000000000010000000000100100101010000000000001011111111100010
0101111111111111111111111100100101010000000000101000000000000010
0100000000001010000000000100100101011111111111101111111111111110
0100000000001010000000000000100101000000000000000000000000000010
0101111111111011111111111111100101111111111111111111111111111110
0100000000001010000000000000100100000000000000000000000000000000
0101111111111010000011111111100111111111111111111111111111111110
0100000000000000000000000000000000000000000000000000000000000010
0111111111111111111111111111111111111111111111111111111111111110
0000000000000000000000000000000000000000000000000000000000000000